22 24
500 500
2 2 2 2 2 2 2 2 2 2 2 2 2 2 2 2 2 2 2 2 2 2
2 256 257 257 257 257 257 257 257 257 257 257 257 257 257 257 257 257 257 257 258 2
2 259 0 0 0 0 0 0 0 0 0 0 0 0 0 0 0 0 0 0 261 2
2 259 0 0 0 0 0 0 0 0 0 0 0 0 0 0 0 0 0 0 261 2
2 259 0 0 0 0 0 0 0 0 0 0 0 0 0 0 0 0 0 0 261 2
2 259 0 0 0 0 0 0 0 0 0 0 0 0 0 0 0 0 0 0 261 2
2 259 0 0 0 0 0 0 0 0 0 0 0 0 0 0 0 0 0 0 261 2
2 259 0 0 0 0 0 0 0 0 0 0 0 0 0 0 0 0 0 0 261 2
2 259 0 0 0 0 0 0 0 0 0 0 0 0 0 0 0 0 0 0 261 2
2 259 0 0 0 0 0 0 0 0 0 0 0 0 0 0 0 0 0 0 261 2
2 259 0 0 0 0 0 0 0 0 0 0 0 0 0 0 0 0 0 0 261 2
2 259 0 0 0 0 0 0 0 0 0 0 0 0 0 0 0 0 0 0 261 2
2 259 0 0 0 0 0 0 0 0 0 0 0 0 0 0 0 0 0 0 261 2
2 259 0 0 0 0 0 0 0 0 0 0 0 0 0 0 0 0 0 0 261 2
2 259 0 0 0 0 0 0 0 0 0 0 0 0 0 0 0 0 0 0 261 2
2 259 0 0 0 0 0 0 0 0 0 0 0 0 0 0 0 0 0 0 261 2
2 259 0 0 0 0 0 0 0 0 0 0 0 0 0 0 0 0 0 0 261 2
2 259 0 0 0 0 0 0 0 0 0 0 0 0 0 0 0 0 0 0 261 2
2 259 0 0 0 0 0 0 0 0 0 0 0 0 0 0 0 0 0 0 261 2
2 259 0 0 0 0 0 0 0 0 0 0 0 0 0 0 0 0 0 0 261 2
2 262 263 263 263 263 263 263 263 263 263 263 263 263 263 263 263 263 263 263 264 2
2 265 266 266 266 266 266 266 266 266 266 266 266 266 266 266 266 266 266 266 267 2
2 268 269 269 269 269 269 269 269 269 269 269 269 269 269 269 269 269 269 269 270 2
2 2 2 2 2 2 2 2 2 2 2 2 2 2 2 2 2 2 2 2 2 2